XXXXXXXXXXXXXXXXXXXXXXXXXXX
X0000000000000000000000000X
X0000000000000000000000000X
X0000000000000000000000000X
X000000000000G000000000000X
X0000000000000000000000000X
X0000000000000000000000000X
X0000000000000000000000000X
X0000000000000000000000000X
X0000X000000000000000X0000X
X0000X000000000000000X0000X
X0000X000000000000000X0000X
X0000X000000000000000X0000X
X0000XXXXXXXXXXXXXXXXX0000X
X0000X000000000000000X0000X
X0000X000000000000000X0000X
X0000X000000000000000X0000X
X0000X000000000000000X0000X
X0000000000000000000000000X
X0000000000000000000000000X
X0000000000000000000000000X
X000000000000S000000000000X
X0000000000000000000000000X
X0000000000000000000000000X
X0000000000000000000000000X
XXXXXXXXXXXXXXXXXXXXXXXXXXX